Hadise - Fifir Tolerans
Modern Talking - Brother Louie
Nines - I See You Shining
Inna feat. Bob Taylor - Deja Mu
Recebin Sanad - Gule Gule
Tarkan - Şımarık
Sia - Cheap Thrills
Dua Lipa - Don't Start Now
Shakira - Waka Waka (This Time for Africa)
Lady Gaga - Bad Romance
Jennifer Lopez - On The Floor
Calvin Harris - Summer
Rihanna - Only Girl (In The World)
The Weeknd - Blinding Lights
Ellie Goulding - Love Me Like You Do
Katy Perry - Firework
Ed Sheeran - Shape of You
Maroon 5 - Sugar
Justin Timberlake - Can't Stop The Feeling!
Pitbull - Timber (feat. Kesha)
Avicii - Wake Me Up
David Guetta - Titanium (feat. Sia)
Bruno Mars - Uptown Funk (feat. Mark Ronson)
Taylor Swift - Shake It Off
Ariana Grande - Problem (feat. Iggy Azalea)
Clean Bandit - Rather Be (feat. Jess Glynne)
Major Lazer - Lean On (feat. MØ & DJ Snake)
Pharrell Williams - Happy
Sam Smith - Stay With Me
Adele - Rolling in the Deep
Beyoncé - Single Ladies (Put a Ring on It)
LMFAO - Party Rock Anthem
OneRepublic - Counting Stars
Calvin Harris - Feel So Close
Flo Rida - Good Feeling
Carly Rae Jepsen - Call Me Maybe
Icona Pop - I Love It (feat. Charli XCX)
Meghan Trainor - All About That Bass
Justin Bieber - Sorry
Shawn Mendes - Stitches
Demi Lovato - Cool for the Summer
Selena Gomez - Come & Get It
Jason Derulo - Want to Want Me
Nicki Minaj - Super Bass
Kesha - Die Young
Zedd - Clarity (feat. Foxes)
Halsey - Without Me
Post Malone - Circles
Jonas Brothers - Sucker
Camila Cabello - Havana (feat. Young Thug)
Black Eyed Peas - I Gotta Feeling
Kygo - Firestone (feat. Conrad Sewell)
Bebe Rexha - Meant to Be (feat. Florida Georgia Line)
Anne-Marie - 2002
Marshmello & Bastille - Happier